1111111111111111111111111
1000000000000000000000001
1000000000000000000000001
1000001111100000000000001
1000000000000000000000001
1010000000000000000000001
1010000000000000000000001
1010000000000000000000001
1010000000000011111100001
1010000000000000000000001
1010000000000000000000001
1000000000000000000000001
1000000000000000000000001
1000000000000000000000001
1001111111111111111100001
1000000000000000000000001
1000000000000000000000001
1000000000000000000000001
1001111111111111100000001
1000000000000000000000001
1000000000000000000000001
1000000000000000000000001
1000000000000000000000001
1000000000000000000000001
1111111111111111111111111
