111111111111111111111111111
111111111111111111111111111
110000000000000000000000011
110000000000000000000000011
110000011111000000000000011
110000000000000000000000011
110100000000000000000000011
110100000000000000000000011
110100000000000000000000011
110100000000000111111000011
110100000000000000000000011
110100000000000000000000011
110000000000000000000000011
110000000000000000000000011
110000000000000000000000011
110011111111111111111000011
110000000000000000000000011
110000000000000000000000011
110000000000000000000000011
110011111111111111000000011
110000000000000000000000011
110000000000000000000000011
110000000000000000000000011
110000000000000000000000011
110000000000000000000000011
111111111111111111111111111
111111111111111111111111111
